ADDISON	same
ALBANY	mixed
ALBURGH	same
ANDOVER	mixed-several
ARLINGTON	same
ATHENS	same
AVERILL	same
AVERYS GORE	same
BAKERSFIELD	mixed
BALTIMORE	same
BARNARD	mixed
BARNET	mixed
BARRE CITY	same
BARRE TOWN	mixed
BARTON	mixed
BELLOWS FALLS	village?
BELVIDERE	same
BENNINGTON	mixed
BENSON	same
BERKSHIRE	mixed
BERLIN	mixed
BETHEL	mixed
BLOOMFIELD	same
BOLTON	mixed-several
BRADFORD	mixed
BRAINTREE	mixed
BRANDON	same
BRATTLEBORO	same
BRIDGEWATER	mixed
BRIDPORT	same
BRIGHTON	mixed
BRISTOL	same
BROOKFIELD	mixed
BROOKLINE	same
BROWNINGTON	mixed-several
BRUNSWICK	same
BUELS GORE	same
BURKE	mixed
BURLINGTON	same
CABOT	mixed
CALAIS	mixed
CAMBRIDGE	mixed
CANAAN	same
CASTLETON	mixed
CAVENDISH	mixed
CHARLESTON	mixed
CHARLOTTE	same
CHELSEA	same
CHESTER	same
CHITTENDEN	same
CLARENDON	same
COLCHESTER	same
CONCORD	mixed
CORINTH	mixed
CORNWALL	mixed-several
COVENTRY	mixed
CRAFTSBURY	mixed
DANBY	mixed
DANVILLE	mixed
DERBY	mixed
DORSET	mixed
DOVER	mixed
DUMMERSTON	mixed
DUXBURY	mixed
EAST HAVEN	same
EAST MONTPELIER	mixed
EDEN	mixed
ELMORE	mixed
ENOSBURGH	mixed
ESSEX JUNCTION CITY	same
ESSEX TOWN	mixed
FAIR HAVEN	same
FAIRFAX	mixed
FAIRFIELD	mixed
FAIRLEE	same
FAYSTON	mixed
FERDINAND	same
FERRISBURGH	mixed
FLETCHER	mixed
FRANKLIN	mixed
GEORGIA	mixed
GLASTENBURY	same
GLOVER	mixed
GOSHEN	same
GRAFTON	mixed
GRANBY	same
GRAND ISLE	same
GRANVILLE	same
GREENSBORO	mixed
GROTON	same
GUILDHALL	same
GUILFORD	same
HALIFAX	mixed
HANCOCK	same
HARDWICK	mixed
HARTFORD	mixed
HARTLAND	mixed
HIGHGATE	mixed
HINESBURG	same
HOLLAND	mixed
HUBBARDTON	same
HUNTINGTON	same
HYDE PARK	same
IRA	same
IRASBURG	mixed
ISLE LA MOTTE	same
JAMAICA	mixed
JAY	same
JERICHO	same
JOHNSON	same
KILLINGTON	same
KIRBY	mixed
LANDGROVE	same
LEICESTER	mixed
LEMINGTON	same
LEWIS	same
LINCOLN	same
LONDONDERRY	mixed
LOWELL	mixed
LUDLOW	same
LUNENBURG	same
LYNDON	mixed
MAIDSTONE	same
MANCHESTER	mixed
MARLBORO	mixed
MARSHFIELD	mixed
MENDON	same
MIDDLEBURY	same
MIDDLESEX	mixed
MIDDLETOWN SPRINGS	same
MILTON	same
MONKTON	mixed
MONTGOMERY	mixed
MONTPELIER	same
MORETOWN	mixed-several
MORGAN	mixed-several
MORRISTOWN	mixed-several
MOUNT HOLLY	mixed
MOUNT TABOR	same
NEW HAVEN	same
NEWARK	mixed
NEWBURY	mixed
NEWFANE	same
NEWPORT CITY	same
NEWPORT TOWN	mixed
NORTH BENNINGTON	village?
NORTH HERO	same
NORTHFIELD	mixed-several
NORTON	same
NORWICH	mixed
ORANGE	mixed
ORLEANS	village?
ORWELL	mixed
PANTON	same
PAWLET	mixed
PEACHAM	mixed
PERU	same
PITTSFIELD	same
PITTSFORD	mixed
PLAINFIELD	village?
PLYMOUTH	mixed
POMFRET	mixed
POULTNEY	same
POWNAL	mixed
PROCTOR	mixed-several
PUTNEY	same
RANDOLPH	same
READING	mixed
READSBORO	same
RICHFORD	same
RICHMOND	same
RIPTON	same
ROCHESTER	same
ROCKINGHAM	mixed
ROXBURY	same
ROYALTON	mixed
RUPERT	mixed
RUTLAND CITY	same
RUTLAND TOWN	mixed
RYEGATE	mixed
SAINT ALBANS CITY	same
SAINT ALBANS TOWN	all to SAINT ALBANS
SAINT GEORGE	same
SAINT JOHNSBURY	mixed
SALISBURY	same
SANDGATE	same
SAXTONS RIVER	village?
SEARSBURG	same
SHAFTSBURY	mixed
SHARON	same
SHEFFIELD	mixed-several
SHELBURNE	same
SHELDON	mixed
SHOREHAM	mixed
SHREWSBURY	same
SOMERSET	same
SOUTH BURLINGTON	same
SOUTH HERO	mixed-several
SPRINGFIELD	mixed
STAMFORD	same
STANNARD	mixed
STARKSBORO	mixed
STOCKBRIDGE	mixed-several
STOWE	same
STRAFFORD	mixed
STRATTON	same
SUDBURY	same
SUNDERLAND	mixed
SUTTON	mixed
SWANTON	mixed
THETFORD	mixed
TINMOUTH	same
TOPSHAM	mixed
TOWNSHEND	mixed
TROY	mixed
TUNBRIDGE	mixed
UNDERHILL	same
VERGENNES	same
VERNON	same
VERSHIRE	same
VICTORY	same
WAITSFIELD	same
WALDEN	mixed
WALLINGFORD	mixed
WALTHAM	same
WARDSBORO	mixed
WARNERS GRANT	same
WARREN	same
WARRENS GORE	same
WASHINGTON	mixed
WATERBURY	mixed
WATERFORD	mixed-several
WATERVILLE	mixed
WEATHERSFIELD	mixed
WELLS	same
WEST FAIRLEE	mixed
WEST HAVEN	same
WEST PAWLET	village?
WEST RUTLAND	same
WEST WINDSOR	mixed
WESTFIELD	mixed
WESTFORD	mixed
WESTMINSTER	mixed
WESTMORE	mixed
WESTON	same
WEYBRIDGE	same
WHEELOCK	mixed
WHITING	same
WHITINGHAM	mixed
WILLIAMSTOWN	mixed
WILLISTON	same
WILMINGTON	same
WINDHAM	mixed
WINDSOR	mixed
WINHALL	mixed
WINOOSKI	same
WOLCOTT	same
WOODBURY	mixed
WOODFORD	same
WOODSTOCK	mixed
WORCESTER	same
